87
15
######################################################################################
######## #############################################################################
########                              #####                                          #
########k############################       ########################### ############ #
################                      #### ############################ ############ #
################### ################# ####   ##########################     ######## #
#   ############### ################# ####   ########################## ### ######## #
#o  ############### ################# ####   ########################## ### ######## #
##                  ###########       ################################# ### ######## #
############################### ##### #################################  ##   ###### #
#k     ######################## ##### #                                  ####  ##### #
###### ######################## ####  ##################################   ### ##### #
#                               #k   #####################################   k #     #
######################################################################################


