101
30
9
####################################################################################################
#o                                                                                                ##
### ##  #######################################   ######### ########## ############# ############ ##
### ### ######################################## ########## ########## #######                    ##
### ### ############   ##############             #####     ########## ###     ######## ######### ##
### ###      ####### ###### ######### ###  ####   ##### ### #######        ###  ####### ######    ##
### ### ###    ##### #####  ######### #### ##### ######  ## ########## ######## ######  ###### #####
### ### ######             ########## #### #####      ##### ########## ######## ###### ####### #####
### ########### ####### ############# #### ##########         ########k########        ####### #####
###      ###### ####### #############      ########## ####################################     #####
### ########### #######          ##### ############## ###########                          #########
### ###         ######## ####### ##### ############## ########### ######################## #########
###      ############### ######  ##### #######   ####   ######### ###########              #########
######## #######   k#### #####  ###### ####### ########           ####################### ##########
#####    ####### ####### ###########    ###### ######## ########                 #k###### ####k#####
######## ##      ####### ##    ##### ## ###### ####     ############### ########## ###### #### #####
########    ############    ##k##### ## #####  ######## ############### ########## #####    ## #####
########################### ##       #                  #######         #########        ## ## #####
###################################### ####### ######## ###################################### #####
#########                               ###### ########             ###                        #####
######### ################ ############ ###### ####################     ############### ############
#######   ################ ############ ###### ######################################## ############
####### # ################   ########## ######                #######################       ########
####### #       ############ ########## ###### ##############  ###################### ##### ########
####### #######                      k  ######   ######   #### ###               #### #####    #####
####### ########## ######### ################## ####### # #### ### ####### ##### ####       ## #####
#######            #########                    #####k  # #### ### #    ## ##### ######## #### k####
####### ########## ############################ #######        ###   ##   k#####          #### #####
####################################################################################################
####################################################################################################
